1111111111
1000100E11
10P0100001
1000100001
10001000C1
1111111111
