11111111
10000P01
1C0E0000
11111111
