11111111
00000P01
1C0E0001
11111111
