11111111
10000P01
1C0E0001
11111101
