1111101
10000P1
1C0E001
1111111
