1111111
1C00001
1110001
1P01001
1111E11
10C0101
1111111
