NO ./textures/space.xpm
EA ./textures/redbrick.xpm
WE ./textures/wood.xpm
SO ./textures/space.xpm

F 122,255,125
C 122,11,24

1111111111111111111
11000000011000011
100000001111010001
 100000000010000001
1000000S00000000011
10000101101000001
10000011 1000000011
11111111 1111111111