NO ./textures/sand.xpm
EA ./textures/sand.xpm
WE ./textures/sand.xpm
SO ./textures/sand.xpm

F 153,76,0
C 51,0,0

1111111111111111111
1100000001100000001
1000000011110000011111111111111111
 100000000000000000000000000000001
 111100000000000000000000000000001
 100100000000W00000000000000000001
 100000000000000000000000000000001
 100100000000000001111111100000001
 111100000000000001      100000001
 100000000000000001      100000001
 100000000000000001      100000001
 100000000000000001      100000001
1111111110000000111111111111111111
1000000111100000000000000000000001
1000000111100000000000000000000001
1000000111100000000000000000000001
10000001  110000000000000000000001
11111111   11111111111111111111111
