1111111111111111111111111111111111
1E0000000000000C00000C000000000001
1010011111100000111001000000010101
1110010010101010001001000000010101
100000000C00C0000000000000000000C1
1000000000000000000000000000000001
100000000000C0000001110C0000000001
10C0000001110000C00100000000001001
1C00000001000000000100000000001001
1000100000000C00000100000000001111
1000100000000000000100000000000001
10001C0000000000000100000000000001
100010000000000000P100000000000001
1111111111111111111111111111111111
