1111111111
1000C00001
1000000111
1000000001
1100000001
1000P00001
1000000001
1000000001
10E0000001
1000000001
1111111111
