11111
1C001
1P001
10E01
10C01
11111
